JMY = "countries/JMY.txt"
JPH = "countries/JPH.txt"
JID = "countries/JID.txt"
JNB = "countries/JNB.txt"
JVN = "countries/JVN.txt"
JCM = "countries/JCM.txt"
JLS = "countries/JVN.txt"
JTH = "countries/JTH.txt"
JBR = "countries/JBR.txt"
JKK = "countries/JKK.txt"
JTB = "countries/JTB.txt"
JCH = "countries/JCH.txt"
JGX = "countries/JGX.txt"
JGD = "countries/JGD.txt"
JSX = "countries/JSX.txt"
JXM = "countries/JTB.txt"
JYN = "countries/JYN.txt"
JAH = "countries/JAH.txt"
JSL = "countries/JSL.txt"
JBH = "countries/JBH.txt"
JNP = "countries/JNP.txt"
JES = "countries/JES.txt"
JBY = "countries/JBY.txt"
JYK = "countries/JYK.txt"
JPF = "countries/JPF.txt"
JPZ = "countries/JPZ.txt"
JAZ = "countries/JAZ.txt"
JNZ = "countries/JNZ.txt"

JKZ = "countries/JKZ.txt"
JBK = "countries/JBK.txt"
JPR = "countries/JPR.txt"
JIQ = "countries/JIQ.txt"
JFG = "countries/JFG.txt"
JGW = "countries/JGW.txt"
JWS = "countries/JWS.txt"
JXJ = "countries/JXJ.txt"
JGZ = "countries/JGZ.txt"
JXK = "countries/JXK.txt"
JTN = "countries/JTN.txt"