SPL = "countries/SPL.txt"
SRO = "countries/SRO.txt"
SBL = "countries/SBL.txt"
SHG = "countries/SHG.txt"
SCZ = "countries/SCZ.txt"
SGD = "countries/SGD.txt"
SFN = "countries/SFN.txt"
SGR = "countries/SGR.txt"
SAL = "countries/SAL.txt"
SYG = "countries/SYG.txt"
SSW = "countries/SSW.txt"
SNW = "countries/SNW.txt"
SDN = "countries/SDN.txt"
SAS = "countries/SAS.txt"
SNT = "countries/SNT.txt"
SIT = "countries/SIT.txt"
SBG = "countries/SBG.txt"
SFR = "countries/SFR.txt"
SLX = "countries/SLX.txt"
SIR = "countries/SIR.txt"
SSZ = "countries/SSZ.txt"
SPT = "countries/SPT.txt"
SEG = "countries/SEG.txt"
SSC = "countries/SSC.txt"
SWL = "countries/SWL.txt"
SSP = "countries/SSP.txt"
STR = "countries/STR.txt"
SSL = "countries/SSL.txt"
SNL = "countries/SNL.txt"
STT = "countries/STT.txt"
STI = "countries/STI.txt"
STH = "countries/STH.txt"
SJA = "countries/SJA.txt"
SML = "countries/SML.txt"
SRC = "countries/SRC.txt"
SVT = "countries/SVT.txt"
SCH = "countries/SCH.txt"
SFG = "countries/SFG.txt"
SET = "countries/SET.txt"
SMO = "countries/SMO.txt"
SPE = "countries/SPE.txt"
SMN = "countries/SMN.txt"
SKO = "countries/SKO.txt"
SLA = "countries/SLA.txt"
SKA = "countries/SKA.txt"
SBR = "countries/SBR.txt"
SBN = "countries/SBN.txt"
SRG = "countries/SRG.txt"
SPK = "countries/SPK.txt"
SGU = "countries/SGU.txt"
SHY = "countries/SHY.txt"
SBO = "countries/SBO.txt"
STN = "countries/STN.txt"
SMY = "countries/SMY.txt"
SMD = "countries/SMD.txt"
SAB = "countries/SAB.txt"
SBV = "countries/SBV.txt"
SYE = "countries/SYE.txt"
SMA = "countries/SMA.txt"
SIQ = "countries/SIQ.txt"
SSR = "countries/SSR.txt"
SPI = "countries/SPI.txt"
SLE = "countries/SLE.txt"
SKR = "countries/SKR.txt"
SIM = "countries/SIM.txt"